155555555555555555555555555555555555555555555555555555555551
211111111111111111111111111111111111111111111111111111111113
211111111111111111111111111111111111111111111111111111111113
211111111111111111111111111111111111111111111111111111111113
211111111111111111111111111111111111111111111111111111111113
211111111111111111111111111111111111111111111111111111111113
211111111111111111111111111111111111111111111111111111111113
211111111111111111111111111111111111111111111111111111111113
211111111111111111111111111111111111111111111111111111111113
211111111111111111111111111111111111111111111111111111111113
211111111111111111111111111111111111111111111111111111111113
211111111111111111111111111111111111111111111111111111111113
211111111111111111111111111111111111111111111111111111111113
211111111111111111111111111111111111111111111111111111111113
211111111111111111111111111111111111111111111111111111111113
211111111111111111111111111111111111111111111111111111111113
211111111111111111111111111111111111111111111111111111111113
211111111111111111111111111111111111111111111111111111111113
211111111111111111111111111111111111111111111111111111111113
211111111111111111111111111111111111111111111111111111111113
211111111111111111111111111111111111111111111111111111111113
211111111111111111111111111111111111111111111111111111111113
211111111111111111111111111111111111111111111111111111111113
211111111111111111111111111111111111111111111111111111111113
144444444444444444444444444444444444444444444444444444444441