155555555555555555555555555555555555555555555555555555555551
288888888888888888888888888888888888888888888888888888888883
288888888888888888888888888888888888888888888888888888888883
288888888888888888888888888888888888888888888888888888888883
288888888888888888888888888888888888888888888888888888888883
288888888888888888888888888888888888888888888888888888888883
288888888888888888888888888888888888888888888888888888888883
288888888888888888888888888888888888888888888888888888888883
288888888888888888888888888888888888888888888888888888888883
288888888888888888888888888888888888888888888888888888888883
288888888888888888888888888888888888888888888888888888888883
288888888888888888888888888888888888888888888888888888888883
288888888888888888888888888888888888888888888888888888888883
288888888888888888888888888888888888888888888888888888888883
288888888888888888888888888888888888888888888888888888888883
288888888888888888888888888888888888888888888888888888888883
144444444444444444444444444444444444444444444444444444444441