1555555555555555555555555555555555555555555555555555555555555555555555555551
2777777777777777777777777777777777777777777777777777777777777777777777777773
2777777777777788887787778787778788888788888778888778777878888877777777777773
2777777777777787778787778788778787777787777787777878877878777777777777777773
2777777777777787778787778787878787888788877787777878787878888877777777777773
2777777777777787778787778787788787778787777787777878778877777877777777777773
2777777777777788887778887787778788888788888778888778777878888877777777777773
2777777777777777777777777777777777777777777777777777777777777777777777777773
2777777777777777787778788888788888787778778887787778788888777777777777777773
2777777777777777787778777877777877787778787778787778777877777777777777777773
2777777777777777787778777877777877788888787778787778777877777777777777777773
2777777777777777787878777877777877787778787778787778777877777777777777777773
2777777777777777778787788888777877787778778887778887777877777777777777777773
2777777777777777777777777777777777777777777777777777777777777777777777777773
2777777777777777788887788887778887788888778887787778788888777777777777777773
2777777777777777787778787778787778787777787778788778787777777777777777777773
2777777777777777787778788887788888787888787778787878788888777777777777777773
2777777777777777787778787787787778787778787778787788777778777777777777777773
2777777777777777788887787778787778788888778887787778788888777777777777777773
2777777777777777777777777777777777777777777777777777777777777777777777777773
277777777777777777777777777777777777777777777777777777777777777773
2777777777777777777777777777777777777777777777777777777777777777777777777773
2777777777777777777777777777777777777777777777777777777777777777773
2777777777777777777777777777777777777777777777777777777777777777777777777773
27777777777777777777777777777777777777777777777777777777777777777773
2777777777777777777777777777777777777777777777777777777777777777777777777773
2777777777777777777777777777777777777777777777777777777777777777773
2777777777777777777777777777777777777777777777777777777777777777777777777773
1444444444444444444444444444444444444444444444444444444444444444444444444441